{
    "levelData":[
        {
            "id":1,
			"title":"Into the Dungeon",
			"description":"Use WASD to move\nReach the stairs to delve deeper",
			"sp":[7,13],
			"exit":[7,1],
            "tiles":[
                [ 1, 1, 1, 1, 1, 1, 1, 1, 1, 1, 1, 1, 1, 1, 1],
				[ 1, 1, 1, 1, 1, 1, 1, 2, 1, 1, 1, 1, 1, 1, 1],
				[ 1, 1, 1, 1, 1, 0, 0, 0, 0, 0, 1, 1, 1, 1, 1],
				[ 1, 1, 1, 1, 1, 0, 0, 0, 0, 0, 1, 1, 1, 1, 1],
				[ 1, 1, 1, 1, 0, 0, 0, 0, 0, 0, 0, 1, 1, 1, 1],
				[ 1, 0, 0, 0, 0, 1, 0, 0, 0, 1, 0, 0, 0, 0, 1],
				[ 1, 0, 0, 0, 0, 0, 0, 0, 0, 0, 0, 0, 0, 0, 1],
				[ 1, 0, 0, 0, 0, 1, 0, 0, 0, 1, 0, 0, 0, 0, 1],
				[ 1, 0, 0, 0, 0, 0, 0, 0, 0, 0, 0, 0, 0, 0, 1],
				[ 1, 0, 0, 0, 0, 1, 0, 0, 0, 1, 0, 0, 0, 0, 1],
				[ 1, 0, 0, 0, 0, 0, 0, 0, 0, 0, 0, 0, 0, 0, 1],
				[ 1, 0, 0, 0, 0, 1, 0, 0, 0, 1, 0, 0, 0, 0, 1],
				[ 1, 0, 0, 0, 0, 0, 0, 0, 0, 0, 0, 0, 0, 0, 1],
				[ 1, 0, 0, 0, 0, 0, 0, 0, 0, 0, 0, 0, 0, 0, 1],
                [ 1, 1, 1, 1, 1, 1, 1, 1, 1, 1, 1, 1, 1, 1, 1]],
			"locks":[
                [ 1, 1, 1, 1, 1],
				[ 1, 1, 1, 1, 1],
				[ 1, 1, 1, 1, 1],
				[ 1, 1, 1, 1, 1],
				[ 1, 1, 1, 1, 1]]
        },
		{
            "id":2,
			"title":"Walking Around",
			"description":"This dungeon is long and deep\n Familiarize yourself\n\nR will reset your floor\nM will return you the menu",
			"sp":[7,13],
			"exit":[7,1],
            "tiles":[
                [ 1, 1, 1, 1, 1, 1, 1, 1, 1, 1, 1, 1, 1, 1, 1],
				[ 1, 1, 1, 1, 1, 1, 0, 2, 0, 1, 1, 1, 1, 1, 1],
				[ 1, 1, 1, 1, 1, 1, 0, 0, 0, 1, 1, 1, 1, 1, 1],
				[ 1, 1, 1, 1, 1, 1, 0, 0, 0, 1, 1, 1, 1, 1, 1],
				[ 1, 1, 1, 1, 1, 1, 0, 0, 0, 1, 1, 1, 1, 1, 1],
				[ 1, 1, 1, 1, 1, 1, 0, 0, 0, 1, 1, 1, 1, 1, 1],
				[ 1, 1, 1, 1, 1, 1, 0, 0, 0, 1, 1, 1, 1, 1, 1],
				[ 1, 1, 1, 1, 1, 1, 0, 0, 0, 1, 1, 1, 1, 1, 1],
				[ 1, 1, 1, 1, 1, 1, 0, 0, 0, 1, 1, 1, 1, 1, 1],
				[ 1, 1, 1, 1, 1, 1, 0, 0, 0, 1, 1, 1, 1, 1, 1],
				[ 1, 1, 1, 1, 1, 1, 0, 0, 0, 1, 1, 1, 1, 1, 1],
				[ 1, 1, 1, 1, 1, 1, 0, 0, 0, 1, 1, 1, 1, 1, 1],
				[ 1, 1, 1, 1, 1, 1, 0, 0, 0, 1, 1, 1, 1, 1, 1],
				[ 1, 1, 1, 1, 1, 1, 0, 0, 0, 1, 1, 1, 1, 1, 1],
                [ 1, 1, 1, 1, 1, 1, 1, 1, 1, 1, 1, 1, 1, 1, 1]],
			"locks":[
                [ 1, 1, 1, 1, 1],
				[ 1, 1, 1, 1, 1],
				[ 1, 1, 1, 1, 1],
				[ 1, 1, 1, 1, 1],
				[ 1, 1, 1, 1, 1]]
        },
			{
            "id":3,
			"title":"Tricky Tracks",
			"description":"Some passages may be blocked\nTry dragging different tiles",
			"sp":[7,13],
			"exit":[7,1],
            "tiles":[
                [ 1, 1, 1, 1, 1, 1, 1, 1, 1, 1, 1, 1, 1, 1, 1],
				[ 1, 1, 1, 1, 1, 1, 0, 2, 0, 1, 1, 1, 1, 1, 1],
				[ 1, 1, 1, 1, 1, 1, 0, 0, 0, 1, 1, 1, 1, 1, 1],
				[ 1, 1, 1, 1, 1, 1, 0, 0, 0, 1, 1, 1, 1, 1, 1],
				[ 1, 1, 1, 1, 1, 1, 0, 0, 0, 1, 1, 1, 1, 1, 1],
				[ 1, 1, 1, 1, 1, 1, 0, 0, 0, 1, 1, 1, 1, 1, 1],
				[ 1, 1, 1, 1, 1, 1, 1, 1, 1, 1, 0, 1, 1, 1, 1],
				[ 1, 1, 1, 1, 1, 1, 1, 1, 1, 1, 0, 1, 1, 1, 1],
				[ 1, 1, 1, 1, 1, 1, 1, 1, 1, 1, 0, 1, 1, 1, 1],
				[ 1, 1, 1, 1, 1, 1, 0, 0, 0, 1, 1, 1, 1, 1, 1],
				[ 1, 1, 1, 1, 1, 1, 0, 0, 0, 1, 1, 1, 1, 1, 1],
				[ 1, 1, 1, 1, 1, 1, 0, 0, 0, 1, 1, 1, 1, 1, 1],
				[ 1, 1, 1, 1, 1, 1, 0, 0, 0, 1, 1, 1, 1, 1, 1],
				[ 1, 1, 1, 1, 1, 1, 0, 0, 0, 1, 1, 1, 1, 1, 1],
                [ 1, 1, 1, 1, 1, 1, 1, 1, 1, 1, 1, 1, 1, 1, 1]],
			"locks":[
                [ 1, 1, 1, 1, 1],
				[ 1, 1, 1, 1, 1],
				[ 1, 1, 0, 0, 1],
				[ 1, 1, 1, 1, 1],
				[ 1, 1, 1, 1, 1]]
        },
			{
            "id":4,
			"title":"Exploration",
			"description":"You cant swap tiles\nInvolving the one youre on\n\nReach the end",
			"sp":[7,13],
			"exit":[13,2],
            "tiles":[
                [ 1, 1, 1, 1, 1, 1, 1, 1, 1, 1, 1, 1, 1, 1, 1],
				[ 1, 1, 1, 1, 1, 1, 1, 1, 1, 1, 1, 1, 1, 1, 1],
				[ 1, 1, 1, 1, 1, 1, 1, 1, 1, 1, 1, 1, 0, 2, 1],
				[ 1, 1, 1, 1, 1, 1, 1, 1, 1, 1, 1, 0, 0, 1, 1],
				[ 1, 1, 1, 1, 1, 1, 1, 1, 1, 1, 1, 0, 1, 1, 1],
				[ 1, 1, 1, 1, 1, 1, 1, 1, 1, 1, 0, 0, 1, 1, 1],
				[ 1, 1, 1, 1, 1, 1, 1, 1, 1, 1, 1, 1, 1, 1, 1],
				[ 1, 1, 1, 1, 1, 1, 1, 1, 1, 1, 1, 1, 1, 1, 1],
				[ 1, 1, 1, 1, 1, 1, 1, 1, 1, 1, 1, 1, 1, 1, 1],
				[ 1, 1, 1, 1, 1, 1, 0, 0, 1, 1, 1, 1, 1, 1, 1],
				[ 1, 1, 1, 1, 1, 1, 1, 0, 1, 1, 1, 1, 1, 1, 1],
				[ 1, 1, 1, 1, 1, 1, 0, 0, 0, 1, 1, 1, 1, 1, 1],
				[ 1, 1, 1, 1, 1, 1, 0, 0, 0, 1, 1, 1, 1, 1, 1],
				[ 1, 1, 1, 1, 1, 1, 0, 0, 0, 1, 1, 1, 1, 1, 1],
                [ 1, 1, 1, 1, 1, 1, 1, 1, 1, 1, 1, 1, 1, 1, 1]],
			"locks":[
                [ 1, 1, 1, 1, 1],
				[ 1, 1, 1, 0, 1],
				[ 1, 1, 0, 0, 1],
				[ 1, 1, 0, 1, 1],
				[ 1, 1, 1, 1, 1]]
        },
			{
            "id":5,
			"title":"Warming Up",
			"description":"The dungeon is constantly shifting\nMaking descension difficult",
			"sp":[1,13],
			"exit":[11,1],
            "tiles":[
                [ 1, 1, 1, 1, 1, 1, 1, 1, 1, 1, 1, 1, 1, 1, 1],
				[ 1, 1, 1, 1, 1, 1, 1, 1, 1, 1, 1, 2, 1, 1, 1],
				[ 1, 1, 1, 1, 1, 1, 1, 1, 1, 1, 1, 0, 1, 1, 1],
				[ 1, 1, 1, 1, 0, 1, 1, 1, 1, 0, 0, 0, 0, 0, 1],
				[ 1, 1, 1, 1, 0, 0, 0, 0, 0, 0, 1, 1, 1, 1, 1],
				[ 1, 1, 1, 1, 1, 1, 1, 0, 1, 1, 1, 0, 1, 1, 1],
				[ 1, 1, 1, 1, 1, 1, 1, 1, 1, 1, 1, 1, 1, 1, 1],
				[ 1, 1, 1, 0, 1, 1, 1, 1, 1, 0, 0, 1, 1, 1, 1],
				[ 1, 1, 1, 0, 0, 1, 1, 1, 1, 1, 0, 1, 1, 1, 1],
				[ 1, 1, 1, 0, 1, 1, 1, 1, 0, 1, 0, 1, 1, 1, 1],
				[ 1, 0, 0, 1, 1, 1, 1, 1, 1, 1, 0, 1, 1, 1, 1],
				[ 1, 0, 0, 0, 1, 1, 1, 1, 0, 1, 0, 1, 1, 1, 1],
				[ 1, 0, 1, 1, 1, 1, 1, 1, 1, 1, 0, 1, 1, 1, 1],
				[ 1, 0, 0, 1, 1, 1, 1, 1, 1, 1, 1, 1, 1, 1, 1],
                [ 1, 1, 1, 1, 1, 1, 1, 1, 1, 1, 1, 1, 1, 1, 1]],
			"locks":[
                [ 0, 1, 1, 1, 1],
				[ 1, 0, 1, 0, 0],
				[ 1, 1, 0, 1, 1],
				[ 1, 0, 0, 1, 1],
				[ 1, 0, 0, 0, 1]]
        },
		{
            "id":6,
			"title":"Misdirection",
			"description":"Some sets of stairs may deceive",
			"sp":[13,7],
			"exit":[1,10],
            "tiles":[
                [ 1, 1, 1, 1, 1, 1, 1, 1, 1, 1, 1, 1, 1, 1, 1],
				[ 1, 1, 1, 1, 1, 1, 1, 1, 1, 1, 1, 1, 1, 1, 1],
				[ 1, 1, 1, 1, 1, 1, 1, 1, 1, 1, 1, 1, 1, 1, 1],
				[ 1, 1, 0, 1, 1, 1, 1, 1, 1, 1, 1, 1, 1, 1, 1],
				[ 1, 2, 0, 1, 1, 1, 0, 1, 1, 1, 0, 0, 0, 0, 1],
				[ 1, 1, 1, 1, 1, 1, 0, 0, 1, 1, 1, 1, 1, 1, 1],
				[ 1, 1, 0, 1, 1, 1, 0, 0, 1, 0, 1, 0, 0, 0, 1],
				[ 1, 2, 0, 1, 1, 1, 0, 0, 0, 0, 0, 0, 0, 0, 1],
				[ 1, 1, 0, 1, 1, 1, 0, 0, 1, 0, 1, 0, 0, 0, 1],
				[ 1, 1, 1, 1, 1, 1, 0, 0, 1, 1, 1, 1, 1, 1, 1],
				[ 1, 2, 0, 1, 1, 1, 0, 1, 1, 1, 0, 0, 0, 0, 1],
				[ 1, 1, 0, 1, 1, 1, 1, 1, 1, 1, 1, 1, 1, 1, 1],
				[ 1, 1, 1, 1, 1, 1, 1, 1, 1, 1, 1, 1, 1, 1, 1],
				[ 1, 1, 1, 1, 1, 1, 1, 1, 1, 1, 1, 1, 1, 1, 1],
                [ 1, 1, 1, 1, 1, 1, 1, 1, 1, 1, 1, 1, 1, 1, 1]],
			"locks":[
                [ 1, 1, 1, 1, 1],
				[ 1, 0, 1, 1, 1],
				[ 1, 0, 1, 0, 1],
				[ 1, 0, 1, 1, 1],
				[ 1, 1, 1, 1, 1]]
        },
				{
            "id":7,
			"title":"Corner Persuasion",
			"description":"Some floors seem impossible...\nPress space for a new perspective",
			"sp":[7,2],
			"exit":[2,7],
            "tiles":[
                [ 1, 1, 1, 1, 1, 1, 1, 1, 1, 1, 1, 1, 1, 1, 1],
				[ 1, 1, 1, 1, 1, 1, 0, 0, 0, 1, 1, 1, 1, 1, 1],
				[ 1, 1, 1, 1, 1, 1, 0, 0, 0, 1, 1, 1, 1, 1, 1],
				[ 1, 1, 1, 1, 1, 1, 0, 0, 0, 1, 1, 1, 1, 1, 1],
				[ 1, 1, 1, 1, 1, 1, 0, 0, 0, 1, 1, 1, 1, 1, 1],
				[ 1, 1, 1, 1, 1, 1, 0, 0, 0, 1, 1, 1, 1, 1, 1],
				[ 1, 0, 0, 0, 0, 0, 1, 0, 1, 0, 0, 0, 0, 0, 1],
				[ 1, 0, 2, 0, 0, 0, 1, 0, 1, 0, 0, 0, 2, 0, 1],
				[ 1, 0, 0, 0, 0, 0, 1, 1, 1, 0, 0, 0, 0, 0, 1],
				[ 1, 1, 1, 1, 1, 1, 0, 0, 0, 1, 1, 1, 1, 1, 1],
				[ 1, 1, 1, 1, 1, 1, 0, 0, 0, 1, 1, 1, 1, 1, 1],
				[ 1, 1, 1, 1, 1, 1, 0, 0, 0, 1, 1, 1, 1, 1, 1],
				[ 1, 1, 1, 1, 1, 1, 0, 2, 0, 1, 1, 1, 1, 1, 1],
				[ 1, 1, 1, 1, 1, 1, 0, 0, 0, 1, 1, 1, 1, 1, 1],
                [ 1, 1, 1, 1, 1, 1, 1, 1, 1, 1, 1, 1, 1, 1, 1]],
			"locks":[
                [ 1, 1, 1, 1, 1],
				[ 1, 1, 1, 1, 1],
				[ 1, 1, 0, 1, 1],
				[ 1, 1, 1, 1, 1],
				[ 1, 1, 1, 1, 1]]
        },
			{
            "id":8,
			"title":"Problematic Perspectives",
			"description":"",
			"sp":[2,12],
			"exit":[5,13],
            "tiles":[
                [ 1, 1, 1, 1, 1, 1, 1, 1, 1, 1, 1, 1, 1, 1, 1],
				[ 1, 1, 1, 1, 1, 1, 0, 0, 0, 1, 1, 1, 1, 1, 1],
				[ 1, 1, 1, 1, 1, 1, 1, 0, 1, 1, 1, 1, 1, 1, 1],
				[ 1, 1, 1, 1, 1, 1, 1, 0, 1, 1, 1, 1, 1, 1, 1],
				[ 1, 1, 1, 0, 1, 0, 1, 0, 1, 0, 1, 0, 1, 1, 1],
				[ 1, 1, 0, 0, 0, 0, 0, 0, 0, 0, 0, 0, 1, 1, 1],
				[ 1, 1, 0, 0, 1, 1, 1, 1, 1, 1, 1, 1, 1, 1, 1],
				[ 1, 0, 0, 0, 1, 1, 1, 1, 1, 1, 1, 1, 1, 1, 1],
				[ 1, 0, 0, 0, 0, 0, 0, 1, 1, 1, 1, 1, 1, 1, 1],
				[ 1, 0, 0, 0, 1, 1, 1, 1, 1, 1, 0, 1, 1, 1, 1],
				[ 1, 1, 1, 1, 1, 1, 1, 0, 1, 1, 0, 1, 1, 1, 1],
				[ 1, 0, 0, 0, 1, 1, 1, 1, 1, 1, 1, 1, 1, 1, 1],
				[ 1, 0, 0, 0, 1, 1, 1, 0, 1, 1, 1, 1, 1, 1, 1],
				[ 1, 0, 0, 0, 1, 2, 0, 0, 1, 1, 1, 1, 1, 1, 1],
                [ 1, 1, 1, 1, 1, 1, 1, 1, 1, 1, 1, 1, 1, 1, 1]],
			"locks":[
                [ 1, 1, 0, 1, 1],
				[ 1, 1, 1, 1, 1],
				[ 1, 1, 1, 0, 1],
				[ 1, 0, 0, 0, 1],
				[ 1, 1, 1, 1, 1]]
        },
		{
            "id":9,
			"title":"Revolving Doors",
			"description":"",
			"sp":[1,1],
			"exit":[2,10],
            "tiles":[
                [ 1, 1, 1, 1, 1, 1, 1, 1, 1, 1, 1, 1, 1, 1, 1],
				[ 1, 0, 0, 0, 1, 1, 0, 0, 0, 1, 1, 1, 1, 1, 1],
				[ 1, 0, 0, 0, 1, 1, 0, 0, 0, 1, 1, 1, 1, 1, 1],
				[ 1, 0, 0, 1, 0, 1, 0, 0, 0, 1, 1, 1, 1, 1, 1],
				[ 1, 1, 1, 0, 0, 1, 0, 0, 0, 1, 1, 1, 1, 1, 1],
				[ 1, 1, 1, 1, 1, 1, 1, 0, 1, 1, 1, 1, 1, 1, 1],
				[ 1, 1, 1, 1, 1, 1, 1, 1, 1, 1, 1, 1, 1, 1, 1],
				[ 1, 1, 1, 1, 1, 1, 1, 1, 1, 0, 1, 1, 1, 1, 1],
				[ 1, 1, 1, 1, 1, 1, 1, 1, 1, 0, 1, 1, 1, 1, 1],
				[ 1, 1, 1, 1, 1, 0, 1, 0, 0, 0, 1, 1, 1, 1, 1],
				[ 1, 1, 2, 0, 0, 0, 1, 1, 1, 1, 1, 1, 1, 1, 1],
				[ 1, 1, 1, 1, 1, 0, 1, 1, 1, 1, 1, 1, 1, 1, 1],
				[ 1, 1, 1, 1, 1, 1, 1, 1, 1, 0, 1, 0, 1, 1, 1],
				[ 1, 1, 1, 1, 1, 1, 1, 1, 1, 0, 1, 1, 1, 1, 1],
                [ 1, 1, 1, 1, 1, 1, 1, 1, 1, 0, 1, 1, 1, 1, 1]],
			"locks":[
                [ 1, 0, 1, 0, 1],
				[ 1, 0, 1, 1, 1],
				[ 1, 1, 0, 1, 1],
				[ 1, 1, 1, 0, 1],
				[ 1, 0, 0, 0, 1]]
        },
		{
            "id":10,
			"title":"Frantic Fanataciscm",
			"description":"Thanks for playing!\n This is the last level for now\nI hope you enjoyed yourself",
			"sp":[2,3],
			"exit":[13,11],
            "tiles":[
                [ 1, 1, 1, 1, 1, 1, 1, 1, 1, 1, 1, 1, 1, 1, 1],
				[ 1, 1, 1, 1, 1, 1, 1, 0, 2, 0, 1, 1, 1, 1, 1],
				[ 1, 1, 1, 1, 1, 1, 1, 0, 0, 0, 1, 1, 2, 1, 1],
				[ 1, 1, 0, 0, 1, 0, 1, 1, 0, 0, 1, 1, 1, 1, 1],
				[ 1, 1, 1, 1, 0, 1, 1, 1, 1, 0, 1, 1, 1, 1, 1],
				[ 1, 1, 1, 0, 1, 0, 1, 1, 0, 1, 1, 1, 1, 1, 1],
				[ 1, 1, 1, 0, 1, 1, 0, 1, 0, 0, 1, 1, 1, 1, 1],
				[ 1, 1, 1, 0, 0, 1, 1, 0, 1, 1, 1, 2, 1, 1, 1],
				[ 1, 1, 1, 1, 0, 1, 2, 0, 1, 1, 1, 1, 1, 1, 1],
				[ 1, 1, 1, 1, 1, 1, 1, 1, 1, 1, 1, 1, 1, 0, 1],
				[ 1, 1, 1, 1, 1, 1, 1, 1, 1, 1, 1, 1, 1, 0, 0],
				[ 1, 1, 2, 1, 1, 1, 1, 1, 1, 1, 1, 1, 1, 2, 0],
				[ 1, 1, 1, 1, 1, 1, 1, 0, 1, 1, 1, 1, 1, 1, 1],
				[ 1, 1, 1, 1, 1, 1, 1, 2, 1, 1, 1, 1, 1, 1, 1],
                [ 1, 1, 1, 1, 1, 1, 1, 1, 1, 1, 1, 1, 1, 1, 1]],
			"locks":[
                [ 1, 1, 1, 1, 1],
				[ 1, 0, 1, 0, 0],
				[ 1, 0, 1, 0, 0],
				[ 1, 0, 0, 0, 1],
				[ 1, 1, 1, 1, 1]]
        }
    ]
}